11111111
1P001001
1001E101
100110C1
11111111
