111111111111111
1P0000000000C01
1C1111111100C01
1C1000001000C01
1C1011111000C01
1C1000000000C01
1C1111111111C01
1C0000000000001
1C1111111111111
1C0000000000001
1C1111111111111
1C0000000000001
1E1111111111111
111111111111111
