11111111111111111111111111111
10000P01110000011111111111011
11100000000011000CCC000000011
100C0001110000000000011111111
11000100000111111000CC0111111
11111100C100000000E0000C11111
11100000000000111000001111111
11111111111111111111111111111